{
	"level":{
		"bgImage":"images/backgrounds/void.png",
		"music":"music/genericRoom.mp3",
		"uiFormat":"defs/combat_ui.json",
		"tileSet":"images/level_1_tiles.png",
		"floorCode":"1",
		"wallCode":"2",
		"pitCode":"3",
		"spikeCode":"4",
		"laserCode":"5",
		"laserBaseCode":"7",
		"goldDoorCode":"11",
		"tileWidth":"16",
		"tileHeight":"16",
		"tileFramesPerLine":"30",
		"scale":"2",
		"tileMap":[
			["0","0","0","0","0","0","0","0","0","0","0","0","0","0","0","0","0","0","0","0","0","0","0","0","0","0","0","0","0","0","0"],
			["0","0","0","0","0","0","0","0","0","0","0","0","0","0","0","2","0","0","2","0","0","0","0","0","0","0","0","0","0","0","0"],
			["0","0","0","0","0","0","0","0","0","0","2","2","2","2","2","2","1","1","2","2","2","2","2","2","0","0","0","0","0","0","0"],
			["0","0","0","0","0","0","0","0","0","0","2","1","1","1","1","1","1","1","1","1","1","1","1","2","0","0","0","0","0","0","0"],
			["0","0","0","0","0","0","0","0","0","0","2","1","1","1","1","1","1","1","1","1","1","1","1","2","0","0","0","0","0","0","0"],
			["0","0","0","0","0","0","0","0","0","0","2","1","1","1","1","3","3","3","3","1","1","1","1","2","0","0","0","0","0","0","0"],
			["0","0","0","0","0","0","0","0","0","0","2","1","1","1","1","1","1","1","1","1","1","1","1","2","0","0","0","0","0","0","0"],
			["0","0","0","0","0","0","0","0","0","0","2","1","1","3","1","1","1","1","1","1","3","1","1","2","0","0","0","0","0","0","0"],
			["0","0","0","0","0","0","0","0","0","0","2","1","1","3","1","1","1","1","1","1","3","1","1","2","0","0","0","0","0","0","0"],
			["0","0","0","0","0","0","0","0","0","0","2","1","1","3","1","1","1","1","1","1","3","1","1","2","0","0","0","0","0","0","0"],
			["0","0","0","0","0","0","0","0","0","0","2","1","1","3","1","1","1","1","1","1","3","1","1","2","0","0","0","0","0","0","0"],
			["0","0","0","0","0","0","0","0","0","0","2","1","1","1","1","1","1","1","1","1","1","1","1","2","0","0","0","0","0","0","0"],
			["0","0","0","0","0","0","0","0","0","0","2","1","1","1","1","3","3","3","3","1","1","1","1","2","0","0","0","0","0","0","0"],
			["0","0","0","0","0","0","0","0","0","0","2","1","1","1","1","1","1","1","1","1","1","1","1","2","0","0","0","0","0","0","0"],
			["0","0","0","0","0","0","0","0","0","0","2","1","1","1","1","1","1","1","1","1","1","1","1","2","0","0","0","0","0","0","0"],
			["0","0","0","0","0","0","0","0","0","0","2","2","2","2","2","2","1","1","2","2","2","2","2","2","0","0","0","0","0","0","0"],
			["0","0","0","0","0","0","0","0","0","0","0","0","0","0","0","2","1","1","2","0","0","0","0","0","0","0","0","0","0","0","0"],
			["0","0","0","0","0","0","0","0","0","0","0","0","0","0","0","2","0","0","2","0","0","0","0","0","0","0","0","0","0","0","0"],
			["0","0","0","0","0","0","0","0","0","0","0","0","0","0","0","0","0","0","0","0","0","0","0","0","0","0","0","0","0","0","0"]
		],
		"player spawn":{
			"x":"16",
			"y":"2",
			"North" : {
				"x": 16,
				"y": 2
			},
			"South" : {
				"x" : 16,
				"y" : 16
			}
		},
		"obstacles" : [
			{
				"type": "transition",
				"x" : 16,
				"y" : 17,
				"toLevel" : "defs/floor1_room9.json",
				"toPoint" : "North",
				"spriteFrame" : 18
			},
			{
				"type": "transition",
				"x" : 17,
				"y" : 17,
				"toLevel" : "defs/floor1_room9.json",
				"toPoint" : "North",
				"spriteFrame" : 19
			}
		]
	}
}