{
	"level":{
		"bgImage":"images/backgrounds/void.png",
		"music":"music/genericRoom.mp3",
		"uiFormat":"defs/combat_ui.json",
		"tileSet":"images/level_1_tiles.png",
		"floorCode":"1",
		"wallCode":"2",
		"pitCode":"3",
		"spikeCode":"4",
		"laserCode":"5",
		"laserBaseCode":"7",
		"goldDoorCode":"11",
		"tileWidth":"16",
		"tileHeight":"16",
		"tileFramesPerLine":"30",
		"scale":"2",
		"tileMap":[
			["0","0","0","0","0","0","0","0","0","0","0","0","0","0","0","0","0","0","0","0","0","0","0","0","0","0","0","0","0","0","0","0","0","0"],
			["0","0","0","0","0","0","0","0","0","0","0","0","0","0","0","0","0","0","0","0","0","0","0","0","0","0","0","0","0","0","0","0","0","0"],
			["0","0","0","0","0","0","0","0","0","0","0","0","0","0","0","0","0","0","0","0","0","0","0","0","0","0","0","0","0","0","0","0","0","0"],
			["0","0","0","0","0","0","0","0","0","0","2","2","2","2","2","2","2","2","2","2","0","0","0","0","0","0","0","0","0","0","0","0","0","0"],
			["0","0","0","0","0","0","0","0","0","0","2","1","1","1","1","1","1","1","1","2","0","0","0","0","0","0","0","0","0","0","0","0","0","0"],
			["0","0","0","0","0","0","0","0","0","0","0","1","1","1","1","1","1","1","1","2","0","0","0","0","0","0","0","0","0","0","0","0","0","0"],
			["0","0","0","0","0","0","0","0","0","0","0","1","1","1","1","1","1","1","1","2","0","0","0","0","0","0","0","0","0","0","0","0","0","0"],
			["0","0","0","0","0","0","0","0","0","0","2","2","2","2","2","2","1","1","1","2","0","0","0","0","0","0","0","0","0","0","0","0","0","0"],
			["0","0","0","0","0","0","0","0","0","0","0","0","0","0","0","2","1","1","1","2","0","0","0","0","0","0","0","0","0","0","0","0","0","0"],
			["0","0","0","0","0","0","0","0","0","0","0","0","0","0","0","2","1","1","1","2","0","0","0","0","0","0","0","0","0","0","0","0","0","0"],
			["0","0","0","0","0","0","0","0","0","0","0","0","0","0","0","2","1","1","1","2","0","0","0","0","0","0","0","0","0","0","0","0","0","0"],
			["0","0","0","0","0","0","0","0","0","0","0","0","0","0","0","2","1","1","1","2","2","2","2","2","2","2","2","2","2","2","2","2","0","0"],
			["0","0","0","0","0","0","0","0","0","0","0","0","0","0","0","2","1","1","1","4","4","4","4","4","4","4","4","4","1","1","1","2","0","0"],
			["0","0","0","0","0","0","0","0","0","0","0","0","0","0","0","2","1","1","1","1","1","1","1","1","1","1","1","1","1","1","1","2","0","0"],
			["0","0","0","0","0","0","0","0","0","0","0","0","0","0","0","2","1","1","1","4","4","4","4","4","4","4","4","4","1","1","1","2","0","0"],
			["0","0","0","0","0","0","0","0","0","0","0","0","0","0","0","2","2","2","2","2","2","2","2","2","2","2","2","2","2","2","2","2","0","0"],
			["0","0","0","0","0","0","0","0","0","0","0","0","0","0","0","0","0","0","0","0","0","0","0","0","0","0","0","0","0","0","0","0","0","0"],
			["0","0","0","0","0","0","0","0","0","0","0","0","0","0","0","0","0","0","0","0","0","0","0","0","0","0","0","0","0","0","0","0","0","0"],
			["0","0","0","0","0","0","0","0","0","0","0","0","0","0","0","0","0","0","0","0","0","0","0","0","0","0","0","0","0","0","0","0","0","0"]
		],
		"player spawn":{
			"x":"11",
			"y":"4"
			"West" : {
				"x": 11,
				"y" : 5
			}
		},
		"upgrades": [
			{
				"type": "bombUpgrade",
				"tag" : "bombs",
				"x" : 29,
				"y" : 13
			}
		],
		"obstacles" : [
			{
				"type": "transition",
				"x" : 10,
				"y" : 5,
				"toLevel" : "defs/floor1_room10.json",
				"toPoint" : "East1",
				"spriteFrame" : 16
			},
			{
				"type": "transition",
				"x" : 10,
				"y" : 6,
				"toLevel" : "defs/floor1_room10.json",
				"toPoint" : "East1",
				"spriteFrame" : 17
			}
		],
		"enemies":[
			{
				"x":"27","y":"13",
				"startDir":"west",
				"type":"sweeper",
				"cycle":"80"
			},
			{
				"x":"20",
				"y":"13",
				"startDir":"west",
				"type":"sweeper",
				"cycle":"80"
			}
		]
	}
}