{
	"level":{
		"bgImage":"images/backgrounds/void.png",
		"music":"music/genericRoom.mp3",
		"uiFormat":"defs/combat_ui.json",
		"tileSet":"images/level_1_tiles.png",
		"floorCode":"1",
		"wallCode":"2",
		"pitCode":"3",
		"spikeCode":"4",
		"laserCode":"5",
		"laserBaseCode":"7",
		"goldDoorCode":"11",
		"tileWidth":"16",
		"tileHeight":"16",
		"tileFramesPerLine":"30",
		"scale":"2",
		"tileMap":[
			["0","0","0","0","0","0","0","0","0","0","0","0","0","0","0","0","0","0","0","0","0","0","0","0","0","0","0","0","0","0","0","0","0","0"],
			["0","0","0","0","0","0","0","0","0","0","0","0","0","0","0","0","0","0","0","0","0","0","0","0","0","0","0","0","0","0","0","0","0","0"],
			["0","0","0","0","0","0","0","0","0","0","0","0","0","0","0","0","0","0","0","0","0","0","0","0","0","0","0","0","0","0","0","0","0","0"],
			["0","0","0","0","0","0","0","0","0","0","0","0","0","0","0","0","0","0","0","0","0","0","0","0","0","0","0","0","0","0","0","0","0","0"],
			["0","0","0","0","0","0","0","0","0","0","2","2","2","2","2","2","2","2","2","2","2","2","2","2","0","0","0","0","0","0","0","0","0","0"],
			["0","0","0","0","0","0","0","0","0","0","2","1","1","1","1","1","2","2","1","1","1","1","1","2","0","0","0","0","0","0","0","0","0","0"],
			["0","0","0","0","0","0","0","0","0","0","2","1","1","1","1","1","3","3","1","1","1","1","1","2","0","0","0","0","0","0","0","0","0","0"],
			["0","0","0","0","0","0","0","0","0","0","2","1","1","1","4","1","3","3","1","2","1","1","1","2","0","0","0","0","0","0","0","0","0","0"],
			["0","0","0","0","0","0","0","0","0","0","2","1","1","1","4","1","3","3","1","2","1","1","1","2","0","0","0","0","0","0","0","0","0","0"],
			["0","0","0","0","0","0","0","0","0","0","0","1","1","1","2","1","3","3","1","4","1","1","1","0","0","0","0","0","0","0","0","0","0","0"],
			["0","0","0","0","0","0","0","0","0","0","0","1","1","1","2","1","3","3","1","4","1","1","1","0","0","0","0","0","0","0","0","0","0","0"],
			["0","0","0","0","0","0","0","0","0","0","2","1","1","1","4","1","3","3","1","2","1","1","1","2","0","0","0","0","0","0","0","0","0","0"],
			["0","0","0","0","0","0","0","0","0","0","2","1","1","1","4","1","3","3","1","2","1","1","1","2","0","0","0","0","0","0","0","0","0","0"],
			["0","0","0","0","0","0","0","0","0","0","2","1","1","1","1","1","3","3","1","1","1","1","1","2","0","0","0","0","0","0","0","0","0","0"],
			["0","0","0","0","0","0","0","0","0","0","2","1","1","1","1","1","2","2","1","1","1","1","1","2","0","0","0","0","0","0","0","0","0","0"],
			["0","0","0","0","0","0","0","0","0","0","2","2","2","2","2","2","2","2","2","2","2","2","2","2","0","0","0","0","0","0","0","0","0","0"],
			["0","0","0","0","0","0","0","0","0","0","0","0","0","0","0","0","0","0","0","0","0","0","0","0","0","0","0","0","0","0","0","0","0","0"],
			["0","0","0","0","0","0","0","0","0","0","0","0","0","0","0","0","0","0","0","0","0","0","0","0","0","0","0","0","0","0","0","0","0","0"],
			["0","0","0","0","0","0","0","0","0","0","0","0","0","0","0","0","0","0","0","0","0","0","0","0","0","0","0","0","0","0","0","0","0","0"]
		],
		"player spawn":{
			"x":"11",
			"y":"5",
			"West" : {
				"x": 11,
				"y" : 9
			},
			"East" : {
				"x": 22,
				"y" : 9
			}
		},
		"obstacles" : [
			{
				"type": "transition",
				"x" : 10,
				"y" : 9,
				"toLevel" : "defs/floor1_room2.json",
				"toPoint" : "East",
				"spriteFrame" : 16
			},
			{
				"type": "transition",
				"x" : 10,
				"y" : 10,
				"toLevel" : "defs/floor1_room2.json",
				"toPoint" : "East",
				"spriteFrame" : 17
			},
			{
				"type": "transition",
				"x" : 23,
				"y" : 9,
				"toLevel" : "defs/floor1_room7.json",
				"toPoint" : "West",
				"spriteFrame" : 12
			},
			{
				"type": "transition",
				"x" : 23,
				"y" : 10,
				"toLevel" : "defs/floor1_room7.json",
				"toPoint" : "West",
				"spriteFrame" : 13
			}
		],
		"enemies":[
			{
				"x":"20",
				"y":"6",
				"startDir":"east",
				"type":"drone"
			},
			{
				"x":"20",
				"y":"13",
				"startDir":"east",
				"type":"drone"
			},
			{
				"x":"13",
				"y":"13",
				"startDir":"north",
				"type":"robot"}
		]
	}
}