{
	"level":{
		"bgImage":"images/backgrounds/void.png",
		"music":"music/genericRoom.mp3",
		"uiFormat":"defs/combat_ui.json",
		"tileSet":"images/level_1_tiles.png",
		"floorCode":"1",
		"wallCode":"2",
		"pitCode":"3",
		"spikeCode":"4",
		"laserCode":"5",
		"laserBaseCode":"7",
		"goldDoorCode":"11",
		"tileWidth":"16",
		"tileHeight":"16",
		"tileFramesPerLine":"30",
		"scale":"2",
		"tileMap":[
			["0","0","0","0","0","0","0","0","0","0","0","0","0","0","0","0","0","0","0","0","0","0","0","0","0","0","0","0","0","0","0","0","0","0"],
			["0","0","0","0","0","0","0","0","0","0","0","0","0","0","0","0","0","0","0","0","0","0","0","0","0","0","0","0","0","0","0","0","0","0"],
			["0","0","0","0","0","0","0","0","0","0","0","0","0","0","0","0","0","0","0","0","0","0","0","0","0","0","0","0","0","0","0","0","0","0"],
			["0","0","0","0","0","0","0","0","0","0","0","0","0","0","0","0","0","0","0","0","0","0","0","0","0","0","0","0","0","0","0","0","0","0"],
			["0","0","0","0","0","0","0","0","0","0","0","0","0","0","0","0","0","0","0","0","0","0","0","0","0","0","0","0","0","0","0","0","0","0"],
			["0","0","0","0","0","0","0","0","0","0","0","0","0","0","0","0","0","0","0","0","0","0","0","0","0","0","0","0","0","0","0","0","0","0"],
			["0","0","0","0","0","0","0","0","0","0","0","0","0","0","2","2","2","2","2","2","2","2","2","2","0","0","0","0","0","0","0","0","0","0"],
			["0","0","0","0","0","0","0","0","0","0","0","0","0","0","2","1","1","1","3","3","1","3","3","2","0","0","0","0","0","0","0","0","0","0"],
			["0","0","0","0","0","0","0","0","0","0","0","0","0","0","2","1","1","1","3","3","3","3","3","2","0","0","0","0","0","0","0","0","0","0"],
			["0","0","0","0","0","0","0","0","0","0","0","0","0","0","2","1","1","1","3","3","3","3","3","2","0","0","0","0","0","0","0","0","0","0"],
			["0","0","0","0","0","0","0","0","0","0","0","0","0","0","2","1","1","1","1","1","1","1","1","0","0","0","0","0","0","0","0","0","0","0"],
			["0","0","0","0","0","0","0","0","0","0","0","0","0","0","2","1","1","1","1","1","1","1","1","0","0","0","0","0","0","0","0","0","0","0"],
			["0","0","0","0","0","0","0","0","0","0","0","0","0","0","2","1","1","1","3","3","3","3","3","2","0","0","0","0","0","0","0","0","0","0"],
			["0","0","0","0","0","0","0","0","0","0","0","0","0","0","2","1","1","1","3","3","3","3","3","2","0","0","0","0","0","0","0","0","0","0"],
			["0","0","0","0","0","0","0","0","0","0","0","0","0","0","2","1","1","1","3","1","3","3","3","2","0","0","0","0","0","0","0","0","0","0"],
			["0","0","0","0","0","0","0","0","0","0","0","0","0","0","2","2","2","2","2","2","2","2","2","2","0","0","0","0","0","0","0","0","0","0"],
			["0","0","0","0","0","0","0","0","0","0","0","0","0","0","0","0","0","0","0","0","0","0","0","0","0","0","0","0","0","0","0","0","0","0"],
			["0","0","0","0","0","0","0","0","0","0","0","0","0","0","0","0","0","0","0","0","0","0","0","0","0","0","0","0","0","0","0","0","0","0"],
			["0","0","0","0","0","0","0","0","0","0","0","0","0","0","0","0","0","0","0","0","0","0","0","0","0","0","0","0","0","0","0","0","0","0"]
		],
		"player spawn":{
			"x":"15",
			"y":"7",
			"East" : {
				"x": 22,
				"y" : 10
			}
		},
		"upgrades": [
			{
				"type": "sword",
				"tag" : "sword",
				"x" : 16,
				"y" : 11
			}
		]
		"events": [
			{
				"event" : "defs/events/sword_dialogue.json",
				"x" : 16,
				"y" : 11,
				"width": 1,
				"height": 1
			}
		],
		"obstacles" : [
			{
				"type": "transition",
				"x" : 23,
				"y" : 10,
				"toLevel" : "defs/floor1_room4.json",
				"toPoint" : "West",
				"spriteFrame" : 12
			},
			{
				"type": "transition",
				"x" : 23,
				"y" : 11,
				"toLevel" : "defs/floor1_room4.json",
				"toPoint" : "West",
				"spriteFrame" : 13
			},
			{
				"type": "laser",
				"x" : 20,
				"y" : 7,
				"startDir" : "south",
				"range" : 7,
				"cycle" : 85
			},
			{
				"type": "laser",
				"x" : 19,
				"y" : 14,
				"startDir" : "north",
				"range" : 7,
				"cycle" : 85
			}
		]
	}
}