{
	"level":{
		"bgImage":"images/backgrounds/void.png",
		"music":"music/genericRoom.mp3",
		"uiFormat":"defs/combat_ui.json",
		"tileSet":"images/level_1_tiles.png",
		"floorCode":"1",
		"wallCode":"2",
		"pitCode":"3",
		"spikeCode":"4",
		"laserCode":"5",
		"laserBaseCode":"7",
		"goldDoorCode":"11",
		"tileWidth":"16",
		"tileHeight":"16",
		"tileFramesPerLine":"30",
		"scale":"2",
		"tileMap":[
			["0","0","0","0","0","0","0","0","0","0","0","0","0","0","0","0","0","0","0","0","0","0","0","0","0","0","0","0","0","0","0","0","0","0"],
			["0","0","0","0","0","0","0","0","0","0","0","0","0","0","0","0","0","0","0","0","0","0","0","0","0","0","0","0","0","0","0","0","0","0"],
			["0","0","0","0","0","0","0","0","0","0","0","0","0","0","0","0","0","0","0","0","0","0","0","0","0","0","0","0","0","0","0","0","0","0"],
			["0","0","0","0","0","0","0","0","0","0","0","0","0","0","0","0","0","0","0","0","0","0","0","0","0","0","0","0","0","0","0","0","0","0"],
			["0","0","0","0","0","0","0","0","0","0","0","0","0","0","0","0","0","0","0","0","0","0","0","0","0","0","0","0","0","0","0","0","0","0"],
			["0","0","0","0","0","0","0","0","0","0","0","0","0","0","0","0","0","0","0","0","0","0","0","0","0","0","0","0","0","0","0","0","0","0"],
			["0","0","0","0","0","0","0","0","0","0","0","0","0","0","2","2","2","0","0","2","2","2","0","0","0","0","0","0","0","0","0","0","0","0"],
			["0","0","0","0","0","0","0","0","0","0","0","0","0","0","2","1","1","1","1","1","1","2","0","0","0","0","0","0","0","0","0","0","0","0"],
			["0","0","0","0","0","0","0","0","0","0","0","0","0","0","2","1","1","1","1","1","1","2","0","0","0","0","0","0","0","0","0","0","0","0"],
			["0","0","0","0","0","0","0","0","0","0","0","0","0","0","2","1","1","1","1","1","1","2","0","0","0","0","0","0","0","0","0","0","0","0"],
			["0","0","0","0","0","0","0","0","0","0","0","0","0","0","2","1","1","1","1","1","1","2","0","0","0","0","0","0","0","0","0","0","0","0"],
			["0","0","0","0","0","0","0","0","0","0","0","0","0","0","2","1","1","1","1","1","1","2","0","0","0","0","0","0","0","0","0","0","0","0"],
			["0","0","0","0","0","0","0","0","0","0","0","0","0","0","2","2","2","2","2","2","2","2","0","0","0","0","0","0","0","0","0","0","0","0"],
			["0","0","0","0","0","0","0","0","0","0","0","0","0","0","0","0","0","0","0","0","0","0","0","0","0","0","0","0","0","0","0","0","0","0"],
			["0","0","0","0","0","0","0","0","0","0","0","0","0","0","0","0","0","0","0","0","0","0","0","0","0","0","0","0","0","0","0","0","0","0"],
			["0","0","0","0","0","0","0","0","0","0","0","0","0","0","0","0","0","0","0","0","0","0","0","0","0","0","0","0","0","0","0","0","0","0"],
			["0","0","0","0","0","0","0","0","0","0","0","0","0","0","0","0","0","0","0","0","0","0","0","0","0","0","0","0","0","0","0","0","0","0"],
			["0","0","0","0","0","0","0","0","0","0","0","0","0","0","0","0","0","0","0","0","0","0","0","0","0","0","0","0","0","0","0","0","0","0"],
			["0","0","0","0","0","0","0","0","0","0","0","0","0","0","0","0","0","0","0","0","0","0","0","0","0","0","0","0","0","0","0","0","0","0"]
		],
		"obstacles" : [
			{
				"type": "transition",
				"x" : 17,
				"y" : 6,
				"toLevel" : "defs/floor1_room2.json",
				"toPoint" : "South",
				"spriteFrame" : 14
			},
			{
				"type": "transition",
				"x" : 18,
				"y" : 6,
				"toLevel" : "defs/floor1_room2.json",
				"toPoint" : "South",
				"spriteFrame" : 15
			},
			{
				"type": "savePoint",
				"x" : 18,
				"y" : 9,
				"spriteFrame" : 20
			}
		],
		"events": [
			{
				"event" : "defs/events/room1_1_StartDialogue.json",
				"x" : 14,
				"y" : 6,
				"width": 8,
				"height": 7
			}
		],
		"player spawn":{
			"x":"17",
			"y":"9",
			"North" : {
				"x": 17,
				"y" : 7
			}
		}
	}
}