{
	"level":{
		"bgImage":"images/backgrounds/void.png",
		"music":"music/genericRoom.mp3",
		"uiFormat":"defs/combat_ui.json",
		"tileSet":"images/level_1_tiles.png",
		"tileMap":[
			["0","0","0","0","0","0","0","0","0","0","0","0","0","0","0","0","0","0","0","0","0","0","0","0","0","0","0","0","0","0","0","0","0","0"],
			["0","0","0","0","0","0","0","0","0","0","0","0","0","0","0","0","0","0","0","0","0","0","0","0","0","0","0","0","0","0","0","0","0","0"],
			["0","0","0","0","0","0","0","0","0","0","0","0","2","2","2","2","2","2","2","2","2","2","2","2","0","0","0","0","0","0","0","0","0","0"],
			["0","0","0","0","0","0","0","0","0","0","0","0","2","1","1","1","1","1","1","1","1","1","1","2","0","0","0","0","0","0","0","0","0","0"],
			["0","0","0","0","0","0","0","0","0","0","0","0","2","1","1","1","1","1","1","1","1","1","1","2","0","0","0","0","0","0","0","0","0","0"],
			["0","0","0","0","0","0","0","0","0","0","0","0","2","1","1","1","1","1","1","1","1","1","1","2","0","0","0","0","0","0","0","0","0","0"],
			["0","0","0","0","0","0","0","0","0","0","0","0","2","1","1","1","1","1","1","1","1","1","1","2","0","0","0","0","0","0","0","0","0","0"],
			["0","0","0","0","0","0","0","0","0","0","0","0","2","1","1","1","1","1","1","1","1","1","1","2","0","0","0","0","0","0","0","0","0","0"],
			["0","0","0","0","0","0","0","0","0","0","0","0","2","1","1","1","1","1","1","1","1","1","1","2","0","0","0","0","0","0","0","0","0","0"],
			["0","0","0","0","0","0","0","0","0","0","0","0","2","4","4","4","4","1","1","4","4","4","4","2","0","0","0","0","0","0","0","0","0","0"],
			["0","0","0","0","0","0","0","0","0","0","0","0","2","2","2","2","2","1","1","2","2","2","2","2","0","0","0","0","0","0","0","0","0","0"],
			["0","0","0","0","0","0","0","0","0","0","0","0","0","0","0","0","2","1","1","2","0","0","0","0","0","0","0","0","0","0","0","0","0","0"],
			["0","0","0","0","0","0","0","0","0","0","0","0","0","0","0","0","2","1","1","2","0","0","0","0","0","0","0","0","0","0","0","0","0","0"],
			["0","0","0","0","0","0","0","0","0","0","0","0","0","0","0","0","2","1","1","2","0","0","0","0","0","0","0","0","0","0","0","0","0","0"],
			["0","0","0","0","0","0","0","0","0","0","0","0","0","0","0","0","2","0","0","2","0","0","0","0","0","0","0","0","0","0","0","0","0","0"],
			["0","0","0","0","0","0","0","0","0","0","0","0","0","0","0","0","0","0","0","0","0","0","0","0","0","0","0","0","0","0","0","0","0","0"],
			["0","0","0","0","0","0","0","0","0","0","0","0","0","0","0","0","0","0","0","0","0","0","0","0","0","0","0","0","0","0","0","0","0","0"],
			["0","0","0","0","0","0","0","0","0","0","0","0","0","0","0","0","0","0","0","0","0","0","0","0","0","0","0","0","0","0","0","0","0","0"],
			["0","0","0","0","0","0","0","0","0","0","0","0","0","0","0","0","0","0","0","0","0","0","0","0","0","0","0","0","0","0","0","0","0","0"]
		],
		"player spawn":{
			"x": 16,
			"y": 5,
			"South" : {
				"x": 17,
				"y": 13
			}
		},
		"obstacles" : [
			{
				"type": "transition",
				"x" : 17,
				"y" : 14,
				"toLevel" : "defs/room1_7.json",
				"toPoint" : "North",
				"spriteFrame" : 18
			},
			{
				"type": "transition",
				"x" : 18,
				"y" : 14,
				"toLevel" : "defs/room1_7.json",
				"toPoint" : "North",
				"spriteFrame" : 19
			}
		],
		"bosses" : [
			{
				"type": "boss_one",
				"x" : 17,
				"y" : 4
			}
		],
		"floorCode":"1",
		"wallCode":"2",
		"pitCode":"3",
		"spikeCode":"4",
		"laserCode":"5",
		"laserBaseCode":"7",
		"goldDoorCode":"11",
		"tileWidth":"16",
		"tileHeight":"16",
		"tileFramesPerLine":"30",
		"scale":"2"
	}
}